95359575B59575B
A4A1A2ADA1A6A9A
A5C50575C565956
A7ACA6ABAAA9A6A
E5F5A5D5155565B
ABA9A3ACA6AAADA
D5550575E5D535A
AAA8A2ABABA8A1A
951505551515056
A4A4A2ACA4A4A2A
E5A58575A5A5C53
A9A5A2ADA5A3ACA
D5658535A5C535A
AAA9A4A5A3ACA5A
D55565E5C575E5E

1,1
3,10
